R0 100 100
NO ./textures/purplestone.xpm
SO ./textures/purplestone.xpm
WE ./textures/purplestone.xpm
EA ./textures/purplestone.xpm
S ./textures/barrel.xpm
F 48,48,48
C 192,223,239

1111111111111111111111111
1222200000000000000000S01
11111111111111111111111111111