
  S ./textures/barrel.xpm
R 250 198

NO ./textures/brick.xpm
  SO ./textures/metal.xpm

EA ./textures/wood.xpm


F 125,132,55
    WE ./textures/stone.xpm
C 114,155,162

1111111111111111111111111111
1002000100000000000000200001
1000000100000000000000000001
100E000111111000200000000001
10200201    1000000000000001
1000000111111000000010000001
1000000000000000000010000001
1000000000111111111111111111
10000001111    1110111  
10000001      1111111  
11111111

