R 3000      2000
NO ./textures/brick.xpm
  SO ./textures/metal.xpm
WE      ./textures/purplestone.xpm
EA ./textures/wood.xpm      
S ./textures/barrel.xpm
F   48,48,48
  C       192,223,239

11111111111111111111111111111
    1222200000000000000000W01
11111111111111111111111111111