R 220 180

NO ./textures/text_blue1.xpm
SO ./textures/text_blue1.xpm
WE ./textures/text_blue1.xpm
EA ./textures/text_blue1.xpm


S ./textures/barrel.xpm
F 48,48,48
C 192,223,239

        1111111111111111111111111
        1000000000110000000000001
        1011000001110000003000001
        1001000000000000000000001
111111111011000001110000000000001
100000400011000001110111111111111
11110111111111011100000000001
11110111111111511101510010001
11000000110101011100000010001
10202000000000001100000010001
10062000E04000001101010010001
1100000111010101111101111000111
11110111 1110101 101111010001
11111111 1111111 111111110111
11111111111111111111111110111
1111111100000000000000000011
111100000000030000000000001
1120000000000000000000000011
1100000000000000000000000001
1101111111111111111111111111
11000000000000000001
11111111111111111101
11600000000000000001
11111111111111111111
