F 48,48,48
C 192,223,239
R 1200 600

NO ./textures/purplestone.xpm
SO ./textures/purplestone.xpm



S ./textures/barrel.xpm
WE ./textures/purplestone.xpm
EA ./textures/purplestone.xpm

1111111111111111111111111111
100N000111111000200000000001
1000000000111111111111111111
10000001111   
11111111   
11111111
10000001111
10000000001111111     
11111111111111111    