R 1920   1020

NO ./path_to_the_north_texture
SO ./path_to_the_south_texture
WE ./path_to_the_west_texture
EA ./path_to_the_east_texture


S ./path_to_the_sprite_texture
F 250,100,1


        1111111111111111111111111


C 225,30,0
