R 4000 4000
NO ./textures/purplestone.xpm

SO ./textures/purplestone.xpm

C       0,55,255

WE ./textures/purplestone.xpm
EA      ./textures/purplestone.xpm
F 139,69,19
S ./textures/barrel.xpm

1111111111111111111111111
1222200000000000000000001
1222200000000000000000001
1000000000000000000000001
1001200000000N00000000011
1000000000000000000000001
1000000000000000000000001
1111111111111111111111111
